"","Fiscal.Year","naics","totaliniaccpt","totaliniden","totalinitial","iaccptperc","idenperc"
"1",2009,"11",198,25,223,88.7892376681614,11.2107623318386
"2",2009,"21",768,12,780,98.4615384615385,1.53846153846154
"3",2009,"22",436,6,442,98.6425339366516,1.35746606334842
"4",2009,"23",417,17,434,96.0829493087558,3.91705069124424
"5",2009,"31",793,63,856,92.6401869158879,7.35981308411215
"6",2009,"32",1745,61,1806,96.6223698781838,3.37763012181617
"7",2009,"33",8596,198,8794,97.7484648624062,2.25153513759381
"8",2009,"42",757,71,828,91.4251207729469,8.57487922705314
"9",2009,"44",1279,165,1444,88.5734072022161,11.4265927977839
"10",2009,"45",549,32,581,94.4922547332186,5.50774526678141
"11",2009,"48",577,52,629,91.7329093799682,8.2670906200318
"12",2009,"49",42,6,48,87.5,12.5
"13",2009,"51",2579,193,2772,93.037518037518,6.96248196248196
"14",2009,"52",4784,143,4927,97.0976253298153,2.9023746701847
"15",2009,"53",353,62,415,85.0602409638554,14.9397590361446
"16",2009,"54",45070,13649,58719,76.7553943357346,23.2446056642654
"17",2009,"55",257,20,277,92.7797833935018,7.22021660649819
"18",2009,"56",1492,375,1867,79.9143010176754,20.0856989823246
"19",2009,"61",15752,667,16419,95.9376332297948,4.06236677020525
"20",2009,"62",8425,1288,9713,86.739421394008,13.260578605992
"21",2009,"71",541,75,616,87.8246753246753,12.1753246753247
"22",2009,"72",820,231,1051,78.0209324452902,21.9790675547098
"23",2009,"81",813,146,959,84.7758081334724,15.2241918665276
"24",2009,"92",345,31,376,91.7553191489362,8.24468085106383
"25",2009,"99",2402,511,2913,82.4579471335393,17.5420528664607
"26",2010,"11",124,21,145,85.5172413793103,14.4827586206897
"27",2010,"21",486,9,495,98.1818181818182,1.81818181818182
"28",2010,"22",299,10,309,96.7637540453075,3.23624595469256
"29",2010,"23",258,12,270,95.5555555555556,4.44444444444444
"30",2010,"31",683,94,777,87.9021879021879,12.0978120978121
"31",2010,"32",1261,62,1323,95.3136810279668,4.68631897203326
"32",2010,"33",6770,232,7002,96.6866609540131,3.31333904598686
"33",2010,"42",594,70,664,89.4578313253012,10.5421686746988
"34",2010,"44",910,197,1107,82.2041553748871,17.7958446251129
"35",2010,"45",608,46,654,92.9663608562691,7.03363914373089
"36",2010,"48",400,67,467,85.6531049250535,14.3468950749465
"37",2010,"49",37,5,42,88.0952380952381,11.9047619047619
"38",2010,"51",4101,143,4244,96.6305372290292,3.36946277097078
"39",2010,"52",4341,145,4486,96.7677218011592,3.23227819884084
"40",2010,"53",287,73,360,79.7222222222222,20.2777777777778
"41",2010,"54",38848,3179,42027,92.4358150712637,7.56418492873629
"42",2010,"55",289,15,304,95.0657894736842,4.93421052631579
"43",2010,"56",908,306,1214,74.7940691927512,25.2059308072488
"44",2010,"61",12168,615,12783,95.1889227880779,4.81107721192208
"45",2010,"62",6875,1036,7911,86.9043104537985,13.0956895462015
"46",2010,"71",528,92,620,85.1612903225806,14.8387096774194
"47",2010,"72",634,239,873,72.62313860252,27.37686139748
"48",2010,"81",733,188,921,79.5874049945711,20.4125950054289
"49",2010,"92",227,18,245,92.6530612244898,7.34693877551021
"50",2010,"99",1669,478,2147,77.7363763390778,22.2636236609222
"51",2011,"11",170,22,192,88.5416666666667,11.4583333333333
"52",2011,"21",644,11,655,98.3206106870229,1.6793893129771
"53",2011,"22",287,10,297,96.6329966329966,3.36700336700337
"54",2011,"23",348,15,363,95.8677685950413,4.13223140495868
"55",2011,"31",863,122,985,87.6142131979695,12.3857868020305
"56",2011,"32",1703,74,1777,95.8356781091728,4.16432189082724
"57",2011,"33",9925,273,10198,97.3230045106884,2.67699548931163
"58",2011,"42",836,117,953,87.7229800629591,12.2770199370409
"59",2011,"44",931,252,1183,78.698224852071,21.301775147929
"60",2011,"45",963,59,1022,94.2270058708415,5.77299412915851
"61",2011,"48",422,81,503,83.89662027833,16.10337972167
"62",2011,"49",52,7,59,88.135593220339,11.864406779661
"63",2011,"51",4945,162,5107,96.8278832974349,3.17211670256511
"64",2011,"52",5158,147,5305,97.2290292177191,2.77097078228087
"65",2011,"53",335,106,441,75.9637188208617,24.0362811791383
"66",2011,"54",60742,4285,65027,93.4104295138942,6.58957048610577
"67",2011,"55",344,15,359,95.8217270194986,4.17827298050139
"68",2011,"56",1256,218,1474,85.2103120759837,14.7896879240163
"69",2011,"61",12999,402,13401,97.0002238638908,2.99977613610925
"70",2011,"62",7068,1065,8133,86.9052010328292,13.0947989671708
"71",2011,"71",1047,106,1153,90.8065915004337,9.19340849956635
"72",2011,"72",698,299,997,70.0100300902708,29.9899699097292
"73",2011,"81",861,171,1032,83.4302325581395,16.5697674418605
"74",2011,"92",299,32,331,90.3323262839879,9.66767371601208
"75",2011,"99",1967,532,2499,78.7114845938375,21.2885154061625
"76",2012,"11",140,15,155,90.3225806451613,9.67741935483871
"77",2012,"21",893,20,913,97.8094194961665,2.19058050383352
"78",2012,"22",306,4,310,98.7096774193548,1.29032258064516
"79",2012,"23",329,15,344,95.6395348837209,4.36046511627907
"80",2012,"31",721,77,798,90.3508771929825,9.64912280701754
"81",2012,"32",1780,74,1854,96.0086299892125,3.99137001078749
"82",2012,"33",10410,249,10659,97.6639459611596,2.33605403884042
"83",2012,"42",883,83,966,91.407867494824,8.59213250517598
"84",2012,"44",770,127,897,85.8416945373467,14.1583054626533
"85",2012,"45",1350,51,1401,96.3597430406852,3.64025695931478
"86",2012,"48",435,64,499,87.1743486973948,12.8256513026052
"87",2012,"49",35,4,39,89.7435897435898,10.2564102564103
"88",2012,"51",5494,130,5624,97.6884779516358,2.31152204836415
"89",2012,"52",4717,126,4843,97.3983068346067,2.60169316539335
"90",2012,"53",307,54,361,85.0415512465374,14.9584487534626
"91",2012,"54",89199,4273,93472,95.4285775419377,4.57142245806231
"92",2012,"55",333,24,357,93.2773109243697,6.72268907563025
"93",2012,"56",1087,130,1217,89.3179950698439,10.6820049301561
"94",2012,"61",11235,357,11592,96.9202898550725,3.07971014492754
"95",2012,"62",5654,536,6190,91.3408723747981,8.65912762520194
"96",2012,"71",401,65,466,86.0515021459227,13.9484978540773
"97",2012,"72",368,157,525,70.0952380952381,29.9047619047619
"98",2012,"81",703,109,812,86.576354679803,13.423645320197
"99",2012,"92",231,10,241,95.850622406639,4.149377593361
"100",2012,"99",3028,647,3675,82.3945578231293,17.6054421768707
"101",2013,"11",125,16,141,88.6524822695035,11.3475177304965
"102",2013,"21",673,10,683,98.5358711566618,1.46412884333821
"103",2013,"22",244,7,251,97.2111553784861,2.78884462151394
"104",2013,"23",350,18,368,95.1086956521739,4.89130434782609
"105",2013,"31",538,81,619,86.9143780290792,13.0856219709208
"106",2013,"32",1477,59,1536,96.1588541666667,3.84114583333333
"107",2013,"33",8821,233,9054,97.4265518003093,2.57344819969074
"108",2013,"42",900,106,1006,89.4632206759443,10.5367793240557
"109",2013,"44",645,131,776,83.1185567010309,16.8814432989691
"110",2013,"45",1440,50,1490,96.6442953020134,3.35570469798658
"111",2013,"48",382,52,434,88.0184331797235,11.9815668202765
"112",2013,"49",26,5,31,83.8709677419355,16.1290322580645
"113",2013,"51",4644,151,4795,96.8508863399374,3.14911366006256
"114",2013,"52",3896,130,4026,96.7709885742673,3.22901142573274
"115",2013,"53",231,43,274,84.3065693430657,15.6934306569343
"116",2013,"54",83453,6678,90131,92.5907845247473,7.40921547525269
"117",2013,"55",307,20,327,93.8837920489297,6.11620795107034
"118",2013,"56",1068,142,1210,88.2644628099173,11.7355371900826
"119",2013,"61",12066,446,12512,96.4354219948849,3.56457800511509
"120",2013,"62",5880,414,6294,93.4223069590086,6.57769304099142
"121",2013,"71",264,53,317,83.2807570977918,16.7192429022082
"122",2013,"72",295,98,393,75.0636132315522,24.9363867684478
"123",2013,"81",537,82,619,86.7528271405493,13.2471728594507
"124",2013,"92",179,23,202,88.6138613861386,11.3861386138614
"125",2013,"99",2295,548,2843,80.7245867041857,19.2754132958143
"126",2014,"11",93,11,104,89.4230769230769,10.5769230769231
"127",2014,"21",509,20,529,96.2192816635161,3.78071833648393
"128",2014,"22",219,7,226,96.9026548672566,3.09734513274336
"129",2014,"23",463,38,501,92.4151696606786,7.58483033932136
"130",2014,"31",526,51,577,91.1611785095321,8.83882149046794
"131",2014,"32",1350,45,1395,96.7741935483871,3.2258064516129
"132",2014,"33",7928,195,8123,97.5994090853133,2.40059091468669
"133",2014,"42",1189,150,1339,88.7976101568335,11.2023898431665
"134",2014,"44",641,117,758,84.5646437994723,15.4353562005277
"135",2014,"45",1545,39,1584,97.5378787878788,2.46212121212121
"136",2014,"48",350,34,384,91.1458333333333,8.85416666666667
"137",2014,"49",31,6,37,83.7837837837838,16.2162162162162
"138",2014,"51",5094,191,5285,96.3859981078524,3.61400189214759
"139",2014,"52",4082,104,4186,97.5155279503106,2.48447204968944
"140",2014,"53",340,54,394,86.2944162436548,13.7055837563452
"141",2014,"54",86265,8210,94475,91.3098703360677,8.69012966393226
"142",2014,"55",359,9,368,97.554347826087,2.44565217391304
"143",2014,"56",934,136,1070,87.2897196261682,12.7102803738318
"144",2014,"61",11193,331,11524,97.1277334258938,2.87226657410621
"145",2014,"62",5372,312,5684,94.5109078114004,5.48909218859958
"146",2014,"71",249,61,310,80.3225806451613,19.6774193548387
"147",2014,"72",254,109,363,69.9724517906336,30.0275482093664
"148",2014,"81",532,79,611,87.0703764320786,12.9296235679214
"149",2014,"92",193,21,214,90.1869158878505,9.81308411214953
"150",2014,"99",905,315,1220,74.1803278688525,25.8196721311475
"151",2015,"11",81,15,96,84.375,15.625
"152",2015,"21",374,11,385,97.1428571428571,2.85714285714286
"153",2015,"22",210,10,220,95.4545454545455,4.54545454545455
"154",2015,"23",477,27,504,94.6428571428571,5.35714285714286
"155",2015,"31",460,35,495,92.9292929292929,7.07070707070707
"156",2015,"32",1087,31,1118,97.2271914132379,2.77280858676208
"157",2015,"33",7127,116,7243,98.3984536794146,1.60154632058539
"158",2015,"42",981,106,1087,90.2483900643974,9.75160993560258
"159",2015,"44",532,73,605,87.9338842975207,12.0661157024793
"160",2015,"45",1553,33,1586,97.9192938209332,2.08070617906683
"161",2015,"48",289,26,315,91.7460317460317,8.25396825396825
"162",2015,"49",48,1,49,97.9591836734694,2.04081632653061
"163",2015,"51",5107,134,5241,97.4432360236596,2.55676397634039
"164",2015,"52",4167,109,4276,97.4508886810103,2.54911131898971
"165",2015,"53",274,35,309,88.673139158576,11.3268608414239
"166",2015,"54",69749,5789,75538,92.336307553814,7.66369244618603
"167",2015,"55",402,7,409,98.2885085574572,1.71149144254279
"168",2015,"56",809,107,916,88.3187772925764,11.6812227074236
"169",2015,"61",11581,373,11954,96.8797055378953,3.12029446210473
"170",2015,"62",4934,296,5230,94.34034416826,5.65965583173996
"171",2015,"71",184,41,225,81.7777777777778,18.2222222222222
"172",2015,"72",230,76,306,75.1633986928105,24.8366013071895
"173",2015,"81",469,62,531,88.3239171374765,11.6760828625235
"174",2015,"92",208,18,226,92.0353982300885,7.9646017699115
"175",2015,"99",513,113,626,81.9488817891374,18.0511182108626
"176",2016,"11",81,11,92,88.0434782608696,11.9565217391304
"177",2016,"21",178,11,189,94.1798941798942,5.82010582010582
"178",2016,"22",215,3,218,98.6238532110092,1.37614678899083
"179",2016,"23",455,40,495,91.9191919191919,8.08080808080808
"180",2016,"31",373,28,401,93.0174563591022,6.98254364089776
"181",2016,"32",1059,39,1098,96.448087431694,3.55191256830601
"182",2016,"33",7434,174,7608,97.7129337539432,2.28706624605678
"183",2016,"42",936,175,1111,84.2484248424843,15.7515751575158
"184",2016,"44",521,82,603,86.4013266998342,13.5986733001658
"185",2016,"45",1942,41,1983,97.9324256177509,2.06757438224912
"186",2016,"48",278,43,321,86.6043613707165,13.3956386292835
"187",2016,"49",74,7,81,91.358024691358,8.64197530864197
"188",2016,"51",5337,218,5555,96.0756075607561,3.92439243924392
"189",2016,"52",4376,163,4539,96.4089006389072,3.59109936109275
"190",2016,"53",289,48,337,85.7566765578635,14.2433234421365
"191",2016,"54",61105,8843,69948,87.3577514725225,12.6422485274776
"192",2016,"55",363,12,375,96.8,3.2
"193",2016,"56",1049,201,1250,83.92,16.08
"194",2016,"61",12222,438,12660,96.5402843601896,3.45971563981043
"195",2016,"62",5260,373,5633,93.3783064086632,6.62169359133676
"196",2016,"71",174,42,216,80.5555555555556,19.4444444444444
"197",2016,"72",219,77,296,73.9864864864865,26.0135135135135
"198",2016,"81",426,75,501,85.0299401197605,14.9700598802395
"199",2016,"92",201,23,224,89.7321428571429,10.2678571428571
"200",2016,"99",525,128,653,80.3981623277182,19.6018376722818
"201",2017,"11",72,10,82,87.8048780487805,12.1951219512195
"202",2017,"21",221,5,226,97.787610619469,2.21238938053097
"203",2017,"22",162,7,169,95.8579881656805,4.14201183431953
"204",2017,"23",442,48,490,90.2040816326531,9.79591836734694
"205",2017,"31",318,38,356,89.3258426966292,10.6741573033708
"206",2017,"32",1033,57,1090,94.7706422018349,5.22935779816514
"207",2017,"33",8247,240,8487,97.1721456344998,2.82785436550018
"208",2017,"42",688,148,836,82.2966507177033,17.7033492822967
"209",2017,"44",442,63,505,87.5247524752475,12.4752475247525
"210",2017,"45",3035,64,3099,97.9348176831236,2.06518231687641
"211",2017,"48",232,43,275,84.3636363636364,15.6363636363636
"212",2017,"49",48,5,53,90.5660377358491,9.43396226415094
"213",2017,"51",6117,265,6382,95.8476966468192,4.15230335318082
"214",2017,"52",4018,205,4223,95.1456310679612,4.85436893203883
"215",2017,"53",249,51,300,83,17
"216",2017,"54",52176,12061,64237,81.2242165730031,18.7757834269969
"217",2017,"55",319,15,334,95.5089820359281,4.49101796407186
"218",2017,"56",1087,171,1258,86.4069952305246,13.5930047694754
"219",2017,"61",10816,406,11222,96.3821065763679,3.61789342363215
"220",2017,"62",5218,318,5536,94.2557803468208,5.74421965317919
"221",2017,"71",155,31,186,83.3333333333333,16.6666666666667
"222",2017,"72",195,70,265,73.5849056603774,26.4150943396226
"223",2017,"81",318,70,388,81.9587628865979,18.0412371134021
"224",2017,"92",150,17,167,89.8203592814371,10.1796407185629
"225",2017,"99",408,110,518,78.7644787644788,21.2355212355212
"226",2018,"11",49,26,75,65.3333333333333,34.6666666666667
"227",2018,"21",183,12,195,93.8461538461538,6.15384615384615
"228",2018,"22",191,21,212,90.0943396226415,9.90566037735849
"229",2018,"23",723,145,868,83.294930875576,16.705069124424
"230",2018,"31",359,95,454,79.0748898678414,20.9251101321586
"231",2018,"32",1468,164,1632,89.9509803921569,10.0490196078431
"232",2018,"33",8502,620,9122,93.2032449024337,6.79675509756632
"233",2018,"42",953,358,1311,72.6926010678871,27.3073989321129
"234",2018,"44",570,234,804,70.8955223880597,29.1044776119403
"235",2018,"45",3615,157,3772,95.8377518557794,4.16224814422057
"236",2018,"48",303,95,398,76.1306532663317,23.8693467336683
"237",2018,"49",169,23,192,88.0208333333333,11.9791666666667
"238",2018,"51",6211,633,6844,90.7510227936879,9.2489772063121
"239",2018,"52",5734,711,6445,88.9681923972071,11.0318076027929
"240",2018,"53",352,150,502,70.1195219123506,29.8804780876494
"241",2018,"54",39747,22672,62419,63.677726333328,36.322273666672
"242",2018,"55",415,31,446,93.0493273542601,6.95067264573991
"243",2018,"56",1035,449,1484,69.7439353099731,30.256064690027
"244",2018,"61",10765,548,11313,95.1560152037479,4.8439847962521
"245",2018,"62",5038,453,5491,91.7501365871426,8.2498634128574
"246",2018,"71",137,62,199,68.8442211055276,31.1557788944724
"247",2018,"72",209,155,364,57.4175824175824,42.5824175824176
"248",2018,"81",370,99,469,78.8912579957356,21.1087420042644
"249",2018,"92",193,39,232,83.1896551724138,16.8103448275862
"250",2018,"99",598,229,827,72.3095525997582,27.6904474002418
"251",2019,"11",102,51,153,66.6666666666667,33.3333333333333
"252",2019,"21",215,31,246,87.3983739837398,12.6016260162602
"253",2019,"22",191,25,216,88.4259259259259,11.5740740740741
"254",2019,"23",670,95,765,87.5816993464052,12.4183006535948
"255",2019,"31",388,85,473,82.0295983086681,17.9704016913319
"256",2019,"32",1297,133,1430,90.6993006993007,9.3006993006993
"257",2019,"33",8778,697,9475,92.6437994722955,7.35620052770449
"258",2019,"42",946,297,1243,76.1061946902655,23.8938053097345
"259",2019,"44",546,169,715,76.3636363636364,23.6363636363636
"260",2019,"45",2765,218,2983,92.6919208850151,7.30807911498491
"261",2019,"48",254,93,347,73.1988472622478,26.8011527377522
"262",2019,"49",174,22,196,88.7755102040816,11.2244897959184
"263",2019,"51",6929,817,7746,89.4526207074619,10.5473792925381
"264",2019,"52",5805,741,6546,88.6801099908341,11.3198900091659
"265",2019,"53",445,133,578,76.9896193771626,23.0103806228374
"266",2019,"54",42937,22262,65199,65.8553045292106,34.1446954707894
"267",2019,"55",424,66,490,86.530612244898,13.469387755102
"268",2019,"56",1105,425,1530,72.2222222222222,27.7777777777778
"269",2019,"61",8453,411,8864,95.3632671480144,4.63673285198556
"270",2019,"62",4151,306,4457,93.1343953331837,6.86560466681624
"271",2019,"71",123,53,176,69.8863636363636,30.1136363636364
"272",2019,"72",136,82,218,62.3853211009174,37.6146788990826
"273",2019,"81",275,103,378,72.7513227513228,27.2486772486773
"274",2019,"92",161,27,188,85.6382978723404,14.3617021276596
"275",2019,"99",1054,365,1419,74.277660324172,25.722339675828
